7 16
|--------------|
||F....-.......|
|..-|.@.P...-..|
|.F....-.|.....|
|.-..........P.|
|P....-....|..F|
|--------------|